symbols 1
`  <  >  -  |        ^  {  }  $ ->
~  *  /  =  &        #  (  )  ;  "
~  +  [  ]  %        @  :  ,  .  '


symbols 2
.  <  >  "  '        &  $  {  }  %
!  -  +  =  #        |  :  (  )  ?
`  /  *  \  _        ~  ^  [  ]  @